1111111111
1111110001
1111110/01
1000000001
1000000001
1000011111
1000011111
10000111111111111111111111111
10000000000000000000000000001
11111111111111111111111000001
1....000000000000000000000001
1....000000000000111111111111
1....0000000000001
111111111111111111
