111111111111111111111111111111111111111
1...00000000000000000000000000000000001
1...000000!000000000000000!00000000/001
1...00000000000000000000000000000000001
111111111111111111111111111111111111111
