111111111111111111111111111111111111111
100000000000000000000000000000000000001
100000000000000000000000000000000000001
100000000000000000000000000000000000001
100000000000000000000000010000000000001
100000000000000000000000010000000000001
100000000000000000000000010000000000001
100000000000000000000000010000000000001
100000000000000000000000010000000000001
111111110000111111111111110000000000001
100000010000000000000000010000000000001
100000010000000000000000010000000000001
100000011111111111100000010000000000001
1000000000000000000000000100000/0000001
100000000000000000000000010000000000001
100001111111111111111111111111111111111
10000000000000000000000000...1
10000000000000000000000000...1
111111111111111111111111111111
