111111111111111111111111111111111111111
100000000000000011111111111111111100001
10000000000000001111111111111111110/001
100001111111000011111111111111111100001
100001111111000011111111111111111100001
100001111111000011111111111111111100001
100001111111000000000000000000000000001
100001111111000000000000000000000000001
100001111111000000000000000000000000001
100001111111111111111111111111111111111
100001111111111111111111111111
100000000000000000000000000001
100000000000000000000000000001
111111111111111111111111110001
100000000000000000000000000001
100000000000000000000000000001
100001111111111111111111111111
100001
10000111111111111111111111111111111111111111111111
1000000000000000000000000000000000000000000000...1
1000000000000000000000000000000000000000000000...1
11111111111111111111111111111111111111111111111111
